index,Average Returns,Timesteps,env,algorithm_name,Actor Training Times,Actor Training Steps
0,15.718004125420785,0,Hopper-v3,SYS_QRDW,0,0
1,15.718004125420785,10000,Hopper-v3,SYS_QRDW,5000,5000
2,236.04603859310436,20000,Hopper-v3,SYS_QRDW,10000,10000
3,237.21887058199474,30000,Hopper-v3,SYS_QRDW,15000,15000
4,347.82830108977686,40000,Hopper-v3,SYS_QRDW,20000,20000
5,314.01456614482817,50000,Hopper-v3,SYS_QRDW,25000,25000
6,294.33813641375605,60000,Hopper-v3,SYS_QRDW,30000,30000
7,328.1682430811861,70000,Hopper-v3,SYS_QRDW,35000,35000
8,303.08979605524394,80000,Hopper-v3,SYS_QRDW,40000,40000
9,378.9321304268409,90000,Hopper-v3,SYS_QRDW,45000,45000
10,367.53118769396696,100000,Hopper-v3,SYS_QRDW,50000,50000
11,381.6823459643007,110000,Hopper-v3,SYS_QRDW,55000,55000
12,348.4230375796599,120000,Hopper-v3,SYS_QRDW,60000,60000
13,399.81772268179816,130000,Hopper-v3,SYS_QRDW,65000,65000
14,411.1340345692634,140000,Hopper-v3,SYS_QRDW,70000,70000
15,415.7489851007127,150000,Hopper-v3,SYS_QRDW,75000,75000
16,27.35003219274152,160000,Hopper-v3,SYS_QRDW,80000,80000
17,472.0888616721413,170000,Hopper-v3,SYS_QRDW,85000,85000
18,450.33543082623993,180000,Hopper-v3,SYS_QRDW,90000,90000
19,585.6328126937726,190000,Hopper-v3,SYS_QRDW,95000,95000
20,573.9280292294735,200000,Hopper-v3,SYS_QRDW,100000,100000
21,783.5142139242761,210000,Hopper-v3,SYS_QRDW,105000,105000
22,657.3981859932646,220000,Hopper-v3,SYS_QRDW,110000,110000
23,682.1526092445866,230000,Hopper-v3,SYS_QRDW,115000,115000
24,756.5679912134008,240000,Hopper-v3,SYS_QRDW,120000,120000
25,976.0349777734082,250000,Hopper-v3,SYS_QRDW,125000,125000
26,738.2847101267923,260000,Hopper-v3,SYS_QRDW,130000,130000
27,1634.8503426275458,270000,Hopper-v3,SYS_QRDW,135000,135000
28,1178.5407308270512,280000,Hopper-v3,SYS_QRDW,140000,140000
29,1212.2638767177907,290000,Hopper-v3,SYS_QRDW,145000,145000
30,1067.8549455490656,300000,Hopper-v3,SYS_QRDW,150000,150000
31,1026.2272776159632,310000,Hopper-v3,SYS_QRDW,155000,155000
32,2373.100305609229,320000,Hopper-v3,SYS_QRDW,160000,160000
33,1035.924074356552,330000,Hopper-v3,SYS_QRDW,165000,165000
34,2073.3334438091542,340000,Hopper-v3,SYS_QRDW,170000,170000
35,1299.875046435012,350000,Hopper-v3,SYS_QRDW,175000,175000
36,910.338904334448,360000,Hopper-v3,SYS_QRDW,180000,180000
37,934.5210273177967,370000,Hopper-v3,SYS_QRDW,185000,185000
38,1345.9092359287456,380000,Hopper-v3,SYS_QRDW,190000,190000
39,1057.4125861948944,390000,Hopper-v3,SYS_QRDW,195000,195000
40,974.0764497343913,400000,Hopper-v3,SYS_QRDW,200000,200000
41,2123.257951045716,410000,Hopper-v3,SYS_QRDW,205000,205000
42,2976.4638109915363,420000,Hopper-v3,SYS_QRDW,210000,210000
43,1427.4713023359163,430000,Hopper-v3,SYS_QRDW,215000,215000
44,1386.4452634747038,440000,Hopper-v3,SYS_QRDW,220000,220000
45,3005.729246644197,450000,Hopper-v3,SYS_QRDW,225000,225000
46,2449.296659339744,460000,Hopper-v3,SYS_QRDW,230000,230000
47,1673.7070879878888,470000,Hopper-v3,SYS_QRDW,235000,235000
48,3294.772710005885,480000,Hopper-v3,SYS_QRDW,240000,240000
49,3405.2267430465863,490000,Hopper-v3,SYS_QRDW,245000,245000
50,3082.033284228938,500000,Hopper-v3,SYS_QRDW,250000,250000
51,2983.652081999464,510000,Hopper-v3,SYS_QRDW,255000,255000
52,3263.018580293352,520000,Hopper-v3,SYS_QRDW,260000,260000
53,3007.68687195709,530000,Hopper-v3,SYS_QRDW,265000,265000
54,3210.3433895359703,540000,Hopper-v3,SYS_QRDW,270000,270000
55,1977.2284513249563,550000,Hopper-v3,SYS_QRDW,275000,275000
56,3293.629287263609,560000,Hopper-v3,SYS_QRDW,280000,280000
57,3229.5897530931043,570000,Hopper-v3,SYS_QRDW,285000,285000
58,3196.7684686027196,580000,Hopper-v3,SYS_QRDW,290000,290000
59,3226.3046332730046,590000,Hopper-v3,SYS_QRDW,295000,295000
60,3315.972363596677,600000,Hopper-v3,SYS_QRDW,300000,300000
61,2921.2499407328582,610000,Hopper-v3,SYS_QRDW,305000,305000
62,3358.5574105973456,620000,Hopper-v3,SYS_QRDW,310000,310000
63,3123.355168190767,630000,Hopper-v3,SYS_QRDW,315000,315000
64,3333.351757711807,640000,Hopper-v3,SYS_QRDW,320000,320000
65,3294.1464846940917,650000,Hopper-v3,SYS_QRDW,325000,325000
66,3353.3328375749074,660000,Hopper-v3,SYS_QRDW,330000,330000
67,3284.400082147476,670000,Hopper-v3,SYS_QRDW,335000,335000
68,3229.5708599490918,680000,Hopper-v3,SYS_QRDW,340000,340000
69,3318.545498646758,690000,Hopper-v3,SYS_QRDW,345000,345000
70,3323.8553875108973,700000,Hopper-v3,SYS_QRDW,350000,350000
71,3374.0543298205766,710000,Hopper-v3,SYS_QRDW,355000,355000
72,3157.0591266909114,720000,Hopper-v3,SYS_QRDW,360000,360000
73,3364.9567889420814,730000,Hopper-v3,SYS_QRDW,365000,365000
74,2444.275327601635,740000,Hopper-v3,SYS_QRDW,370000,370000
75,1767.8663335963877,750000,Hopper-v3,SYS_QRDW,375000,375000
76,2370.6422699979394,760000,Hopper-v3,SYS_QRDW,380000,380000
77,2806.7580185944485,770000,Hopper-v3,SYS_QRDW,385000,385000
78,2941.659379953667,780000,Hopper-v3,SYS_QRDW,390000,390000
79,3362.282040457915,790000,Hopper-v3,SYS_QRDW,395000,395000
80,3314.945763792868,800000,Hopper-v3,SYS_QRDW,400000,400000
81,3372.507938094076,810000,Hopper-v3,SYS_QRDW,405000,405000
82,3380.7496102555933,820000,Hopper-v3,SYS_QRDW,410000,410000
83,3476.668103773457,830000,Hopper-v3,SYS_QRDW,415000,415000
84,3419.4316531522936,840000,Hopper-v3,SYS_QRDW,420000,420000
85,3211.326782935677,850000,Hopper-v3,SYS_QRDW,425000,425000
86,3248.92224703583,860000,Hopper-v3,SYS_QRDW,430000,430000
87,3457.260995366259,870000,Hopper-v3,SYS_QRDW,435000,435000
88,3391.991457742957,880000,Hopper-v3,SYS_QRDW,440000,440000
89,3408.047136638531,890000,Hopper-v3,SYS_QRDW,445000,445000
90,3382.5786668595006,900000,Hopper-v3,SYS_QRDW,450000,450000
91,2967.868815156669,910000,Hopper-v3,SYS_QRDW,455000,455000
92,3441.6428473826613,920000,Hopper-v3,SYS_QRDW,460000,460000
93,3438.470751492598,930000,Hopper-v3,SYS_QRDW,465000,465000
94,3181.2107058434553,940000,Hopper-v3,SYS_QRDW,470000,470000
95,3219.141325798529,950000,Hopper-v3,SYS_QRDW,475000,475000
96,3423.38135880578,960000,Hopper-v3,SYS_QRDW,480000,480000
97,3403.779191377775,970000,Hopper-v3,SYS_QRDW,485000,485000
98,3388.353284163209,980000,Hopper-v3,SYS_QRDW,490000,490000
99,3374.099979446953,990000,Hopper-v3,SYS_QRDW,495000,495000
100,3429.548000998424,1000000,Hopper-v3,SYS_QRDW,500000,500000
