index,Average Returns,Timesteps,env,algorithm_name,Actor Training Times,Actor Training Steps
0,-91.50866219709076,0,BipedalWalker-v3,DDPG,0,0
1,-91.50866219709076,10000,BipedalWalker-v3,DDPG,5000,5000
2,-131.1839689810626,20000,BipedalWalker-v3,DDPG,10000,10000
3,-130.12096787455678,30000,BipedalWalker-v3,DDPG,15000,15000
4,-102.13878936084078,40000,BipedalWalker-v3,DDPG,20000,20000
5,-139.29040818220895,50000,BipedalWalker-v3,DDPG,25000,25000
6,-127.18984243584849,60000,BipedalWalker-v3,DDPG,30000,30000
7,-133.53413296251662,70000,BipedalWalker-v3,DDPG,35000,35000
8,-118.3596587734427,80000,BipedalWalker-v3,DDPG,40000,40000
9,-102.29217613242281,90000,BipedalWalker-v3,DDPG,45000,45000
10,-102.09445751934516,100000,BipedalWalker-v3,DDPG,50000,50000
11,-158.03565017262468,110000,BipedalWalker-v3,DDPG,55000,55000
12,-86.8040318876404,120000,BipedalWalker-v3,DDPG,60000,60000
13,-113.10349064802332,130000,BipedalWalker-v3,DDPG,65000,65000
14,-138.6103985897684,140000,BipedalWalker-v3,DDPG,70000,70000
15,-117.72323490921141,150000,BipedalWalker-v3,DDPG,75000,75000
16,-114.78682013556104,160000,BipedalWalker-v3,DDPG,80000,80000
17,-145.86343408569516,170000,BipedalWalker-v3,DDPG,85000,85000
18,-102.38793238920412,180000,BipedalWalker-v3,DDPG,90000,90000
19,-103.45794005899769,190000,BipedalWalker-v3,DDPG,95000,95000
20,-44.39129226199161,200000,BipedalWalker-v3,DDPG,100000,100000
21,184.5777215498076,210000,BipedalWalker-v3,DDPG,105000,105000
22,-111.30232411527443,220000,BipedalWalker-v3,DDPG,110000,110000
23,-142.77623875871055,230000,BipedalWalker-v3,DDPG,115000,115000
24,-105.73804443071491,240000,BipedalWalker-v3,DDPG,120000,120000
25,-147.70977481539296,250000,BipedalWalker-v3,DDPG,125000,125000
26,-151.35442076576663,260000,BipedalWalker-v3,DDPG,130000,130000
27,-57.765626257400285,270000,BipedalWalker-v3,DDPG,135000,135000
28,-86.05781459702494,280000,BipedalWalker-v3,DDPG,140000,140000
29,-7.597354234566017,290000,BipedalWalker-v3,DDPG,145000,145000
30,-37.84182738093246,300000,BipedalWalker-v3,DDPG,150000,150000
31,-96.2089473377926,310000,BipedalWalker-v3,DDPG,155000,155000
32,-115.10905390216129,320000,BipedalWalker-v3,DDPG,160000,160000
33,-103.40992087050995,330000,BipedalWalker-v3,DDPG,165000,165000
34,-109.14894614098424,340000,BipedalWalker-v3,DDPG,170000,170000
35,-113.98474364803421,350000,BipedalWalker-v3,DDPG,175000,175000
36,-97.45278137732784,360000,BipedalWalker-v3,DDPG,180000,180000
37,-108.56833862490817,370000,BipedalWalker-v3,DDPG,185000,185000
38,-94.51575954358215,380000,BipedalWalker-v3,DDPG,190000,190000
39,-97.44558304243652,390000,BipedalWalker-v3,DDPG,195000,195000
40,-103.12849826499651,400000,BipedalWalker-v3,DDPG,200000,200000
41,-103.48810500169148,410000,BipedalWalker-v3,DDPG,205000,205000
42,-99.00161096329708,420000,BipedalWalker-v3,DDPG,210000,210000
43,-165.03083518276998,430000,BipedalWalker-v3,DDPG,215000,215000
44,-140.93514438413257,440000,BipedalWalker-v3,DDPG,220000,220000
45,-119.87055023590759,450000,BipedalWalker-v3,DDPG,225000,225000
46,-101.02854271450876,460000,BipedalWalker-v3,DDPG,230000,230000
47,-78.15840802697454,470000,BipedalWalker-v3,DDPG,235000,235000
48,-92.21492670577395,480000,BipedalWalker-v3,DDPG,240000,240000
49,-120.05032110069892,490000,BipedalWalker-v3,DDPG,245000,245000
50,-125.16957124239164,500000,BipedalWalker-v3,DDPG,250000,250000
51,-150.57517261014945,510000,BipedalWalker-v3,DDPG,255000,255000
52,-141.02872526682842,520000,BipedalWalker-v3,DDPG,260000,260000
53,-66.57927938572604,530000,BipedalWalker-v3,DDPG,265000,265000
54,42.38774931886762,540000,BipedalWalker-v3,DDPG,270000,270000
55,-64.97494049469181,550000,BipedalWalker-v3,DDPG,275000,275000
56,116.10895694636787,560000,BipedalWalker-v3,DDPG,280000,280000
57,-142.2816457595946,570000,BipedalWalker-v3,DDPG,285000,285000
58,-145.5894128888044,580000,BipedalWalker-v3,DDPG,290000,290000
59,-94.06813306043549,590000,BipedalWalker-v3,DDPG,295000,295000
60,-119.3783313644606,600000,BipedalWalker-v3,DDPG,300000,300000
61,-108.68711643861342,610000,BipedalWalker-v3,DDPG,305000,305000
62,-89.2182015950639,620000,BipedalWalker-v3,DDPG,310000,310000
63,-142.1312165593501,630000,BipedalWalker-v3,DDPG,315000,315000
64,-137.9060739297618,640000,BipedalWalker-v3,DDPG,320000,320000
65,-14.552976151281376,650000,BipedalWalker-v3,DDPG,325000,325000
66,0.012384440473820748,660000,BipedalWalker-v3,DDPG,330000,330000
67,-99.26842135731432,670000,BipedalWalker-v3,DDPG,335000,335000
68,-120.40676349775444,680000,BipedalWalker-v3,DDPG,340000,340000
69,-46.88153256965523,690000,BipedalWalker-v3,DDPG,345000,345000
70,32.825301681404795,700000,BipedalWalker-v3,DDPG,350000,350000
71,-134.86835524241002,710000,BipedalWalker-v3,DDPG,355000,355000
72,-130.37715690168122,720000,BipedalWalker-v3,DDPG,360000,360000
73,-73.19586523181064,730000,BipedalWalker-v3,DDPG,365000,365000
74,-158.3046569469894,740000,BipedalWalker-v3,DDPG,370000,370000
75,-133.13294113095608,750000,BipedalWalker-v3,DDPG,375000,375000
76,-204.55145053287745,760000,BipedalWalker-v3,DDPG,380000,380000
77,154.61157521675278,770000,BipedalWalker-v3,DDPG,385000,385000
78,-106.7231563067868,780000,BipedalWalker-v3,DDPG,390000,390000
79,-68.50964132959044,790000,BipedalWalker-v3,DDPG,395000,395000
80,-56.20342232687878,800000,BipedalWalker-v3,DDPG,400000,400000
81,-88.27342677296947,810000,BipedalWalker-v3,DDPG,405000,405000
82,-91.94491191887226,820000,BipedalWalker-v3,DDPG,410000,410000
83,-150.91149233122903,830000,BipedalWalker-v3,DDPG,415000,415000
84,-115.52704059877048,840000,BipedalWalker-v3,DDPG,420000,420000
85,-82.13519870705534,850000,BipedalWalker-v3,DDPG,425000,425000
86,-103.28192836544106,860000,BipedalWalker-v3,DDPG,430000,430000
87,-85.48515819643269,870000,BipedalWalker-v3,DDPG,435000,435000
88,-106.19557975355671,880000,BipedalWalker-v3,DDPG,440000,440000
89,-13.610399072868368,890000,BipedalWalker-v3,DDPG,445000,445000
90,-84.51841155237531,900000,BipedalWalker-v3,DDPG,450000,450000
91,-94.46246554211152,910000,BipedalWalker-v3,DDPG,455000,455000
92,81.32557430399515,920000,BipedalWalker-v3,DDPG,460000,460000
93,-87.38544080703386,930000,BipedalWalker-v3,DDPG,465000,465000
94,-75.04722261652023,940000,BipedalWalker-v3,DDPG,470000,470000
95,-63.3435514599765,950000,BipedalWalker-v3,DDPG,475000,475000
96,-79.70219424949204,960000,BipedalWalker-v3,DDPG,480000,480000
97,-114.28571637266458,970000,BipedalWalker-v3,DDPG,485000,485000
98,-99.92460942197944,980000,BipedalWalker-v3,DDPG,490000,490000
99,64.42091798862242,990000,BipedalWalker-v3,DDPG,495000,495000
100,-85.35405937287534,1000000,BipedalWalker-v3,DDPG,500000,500000
