index,Average Returns,Timesteps,env,algorithm_name,Actor Training Times,Actor Training Steps
0,45.490331395050475,0,Hopper-v3,DDPG,0,0
1,45.490331395050475,10000,Hopper-v3,DDPG,5000,5000
2,39.7172648012676,20000,Hopper-v3,DDPG,10000,10000
3,169.8790858620185,30000,Hopper-v3,DDPG,15000,15000
4,254.47453430706489,40000,Hopper-v3,DDPG,20000,20000
5,295.75122897204466,50000,Hopper-v3,DDPG,25000,25000
6,367.60361991726,60000,Hopper-v3,DDPG,30000,30000
7,263.43171976922724,70000,Hopper-v3,DDPG,35000,35000
8,308.4346500697809,80000,Hopper-v3,DDPG,40000,40000
9,271.0409041049392,90000,Hopper-v3,DDPG,45000,45000
10,373.01368665183367,100000,Hopper-v3,DDPG,50000,50000
11,328.8091229681782,110000,Hopper-v3,DDPG,55000,55000
12,410.94288399396004,120000,Hopper-v3,DDPG,60000,60000
13,294.4851320249728,130000,Hopper-v3,DDPG,65000,65000
14,287.84220302710753,140000,Hopper-v3,DDPG,70000,70000
15,257.47616859203583,150000,Hopper-v3,DDPG,75000,75000
16,227.78831770548427,160000,Hopper-v3,DDPG,80000,80000
17,241.51267684855884,170000,Hopper-v3,DDPG,85000,85000
18,255.05974422496712,180000,Hopper-v3,DDPG,90000,90000
19,275.63069597760534,190000,Hopper-v3,DDPG,95000,95000
20,198.43765197935585,200000,Hopper-v3,DDPG,100000,100000
21,180.3489283580399,210000,Hopper-v3,DDPG,105000,105000
22,269.63516412382387,220000,Hopper-v3,DDPG,110000,110000
23,307.2380115972428,230000,Hopper-v3,DDPG,115000,115000
24,221.94156510164368,240000,Hopper-v3,DDPG,120000,120000
25,228.58695256700088,250000,Hopper-v3,DDPG,125000,125000
26,226.29295817332127,260000,Hopper-v3,DDPG,130000,130000
27,3.957060737761005,270000,Hopper-v3,DDPG,135000,135000
28,48.267755650928834,280000,Hopper-v3,DDPG,140000,140000
29,191.2580513027894,290000,Hopper-v3,DDPG,145000,145000
30,159.00073413004895,300000,Hopper-v3,DDPG,150000,150000
31,189.46196930971084,310000,Hopper-v3,DDPG,155000,155000
32,1059.2895253005465,320000,Hopper-v3,DDPG,160000,160000
33,427.2438462024018,330000,Hopper-v3,DDPG,165000,165000
34,278.4852341450977,340000,Hopper-v3,DDPG,170000,170000
35,619.1312954851551,350000,Hopper-v3,DDPG,175000,175000
36,450.10748002374766,360000,Hopper-v3,DDPG,180000,180000
37,114.37967060251611,370000,Hopper-v3,DDPG,185000,185000
38,63.27857120824842,380000,Hopper-v3,DDPG,190000,190000
39,88.83725459553574,390000,Hopper-v3,DDPG,195000,195000
40,1038.5646267449479,400000,Hopper-v3,DDPG,200000,200000
41,210.530263658268,410000,Hopper-v3,DDPG,205000,205000
42,995.6783555358,420000,Hopper-v3,DDPG,210000,210000
43,113.02098131191543,430000,Hopper-v3,DDPG,215000,215000
44,988.7305864404822,440000,Hopper-v3,DDPG,220000,220000
45,134.62379147810302,450000,Hopper-v3,DDPG,225000,225000
46,620.5787886024193,460000,Hopper-v3,DDPG,230000,230000
47,630.7600722777709,470000,Hopper-v3,DDPG,235000,235000
48,983.1897221153058,480000,Hopper-v3,DDPG,240000,240000
49,999.8622749495884,490000,Hopper-v3,DDPG,245000,245000
50,284.78409805378345,500000,Hopper-v3,DDPG,250000,250000
51,12.78450642562834,510000,Hopper-v3,DDPG,255000,255000
52,441.7721616343634,520000,Hopper-v3,DDPG,260000,260000
53,498.5046839784668,530000,Hopper-v3,DDPG,265000,265000
54,989.2658000915293,540000,Hopper-v3,DDPG,270000,270000
55,980.6540414057381,550000,Hopper-v3,DDPG,275000,275000
56,291.6870713125096,560000,Hopper-v3,DDPG,280000,280000
57,1027.7346530656976,570000,Hopper-v3,DDPG,285000,285000
58,823.1334804623401,580000,Hopper-v3,DDPG,290000,290000
59,649.7002328049044,590000,Hopper-v3,DDPG,295000,295000
60,951.9889780748276,600000,Hopper-v3,DDPG,300000,300000
61,286.1795862620043,610000,Hopper-v3,DDPG,305000,305000
62,245.3040498410261,620000,Hopper-v3,DDPG,310000,310000
63,251.4210908254489,630000,Hopper-v3,DDPG,315000,315000
64,255.12352332363574,640000,Hopper-v3,DDPG,320000,320000
65,883.0094722598727,650000,Hopper-v3,DDPG,325000,325000
66,271.7405773253108,660000,Hopper-v3,DDPG,330000,330000
67,60.888822560221634,670000,Hopper-v3,DDPG,335000,335000
68,771.8618276498222,680000,Hopper-v3,DDPG,340000,340000
69,135.1450885495212,690000,Hopper-v3,DDPG,345000,345000
70,1037.0108694622984,700000,Hopper-v3,DDPG,350000,350000
71,1004.289158779526,710000,Hopper-v3,DDPG,355000,355000
72,412.49515713048834,720000,Hopper-v3,DDPG,360000,360000
73,270.92152284512696,730000,Hopper-v3,DDPG,365000,365000
74,280.82028873243587,740000,Hopper-v3,DDPG,370000,370000
75,426.7449636514773,750000,Hopper-v3,DDPG,375000,375000
76,298.43844609273214,760000,Hopper-v3,DDPG,380000,380000
77,286.4662241293632,770000,Hopper-v3,DDPG,385000,385000
78,341.3816290451128,780000,Hopper-v3,DDPG,390000,390000
79,415.40740355642265,790000,Hopper-v3,DDPG,395000,395000
80,374.7327891931244,800000,Hopper-v3,DDPG,400000,400000
81,316.339388879309,810000,Hopper-v3,DDPG,405000,405000
82,365.19450834206833,820000,Hopper-v3,DDPG,410000,410000
83,440.876201319268,830000,Hopper-v3,DDPG,415000,415000
84,388.5668919112008,840000,Hopper-v3,DDPG,420000,420000
85,411.06426189880193,850000,Hopper-v3,DDPG,425000,425000
86,406.96161638887816,860000,Hopper-v3,DDPG,430000,430000
87,111.93976071760453,870000,Hopper-v3,DDPG,435000,435000
88,336.9096674665377,880000,Hopper-v3,DDPG,440000,440000
89,578.0809716821644,890000,Hopper-v3,DDPG,445000,445000
90,596.8974635872491,900000,Hopper-v3,DDPG,450000,450000
91,390.8776271710698,910000,Hopper-v3,DDPG,455000,455000
92,16.891952296642643,920000,Hopper-v3,DDPG,460000,460000
93,1027.998001822379,930000,Hopper-v3,DDPG,465000,465000
94,374.18273985479607,940000,Hopper-v3,DDPG,470000,470000
95,1067.6970791748806,950000,Hopper-v3,DDPG,475000,475000
96,53.91884712487453,960000,Hopper-v3,DDPG,480000,480000
97,963.241991063569,970000,Hopper-v3,DDPG,485000,485000
98,1055.7161205984733,980000,Hopper-v3,DDPG,490000,490000
99,235.18833572086174,990000,Hopper-v3,DDPG,495000,495000
100,288.95853419177934,1000000,Hopper-v3,DDPG,500000,500000
