index,Average Returns,Timesteps,env,algorithm_name,Actor Training Times,Actor Training Steps
0,991.854605793611,0,Ant-v3,TD3,0,0
1,991.854605793611,10000,Ant-v3,TD3,5000,5000
2,841.2484560642978,20000,Ant-v3,TD3,10000,10000
3,720.0882844051465,30000,Ant-v3,TD3,15000,15000
4,776.0416653143561,40000,Ant-v3,TD3,20000,20000
5,741.1172951396329,50000,Ant-v3,TD3,25000,25000
6,853.6369684211656,60000,Ant-v3,TD3,30000,30000
7,954.2764923974257,70000,Ant-v3,TD3,35000,35000
8,929.2524098916589,80000,Ant-v3,TD3,40000,40000
9,798.7019735461395,90000,Ant-v3,TD3,45000,45000
10,897.9401318637132,100000,Ant-v3,TD3,50000,50000
11,917.8363394771153,110000,Ant-v3,TD3,55000,55000
12,912.9926071295633,120000,Ant-v3,TD3,60000,60000
13,908.547034927578,130000,Ant-v3,TD3,65000,65000
14,928.5855793795573,140000,Ant-v3,TD3,70000,70000
15,881.8332867803889,150000,Ant-v3,TD3,75000,75000
16,954.1407554645473,160000,Ant-v3,TD3,80000,80000
17,950.8039001584008,170000,Ant-v3,TD3,85000,85000
18,999.810662950637,180000,Ant-v3,TD3,90000,90000
19,1024.876050693393,190000,Ant-v3,TD3,95000,95000
20,963.4671330506213,200000,Ant-v3,TD3,100000,100000
21,960.9620259210308,210000,Ant-v3,TD3,105000,105000
22,986.1802145451097,220000,Ant-v3,TD3,110000,110000
23,1026.4690062495283,230000,Ant-v3,TD3,115000,115000
24,1173.2385706559692,240000,Ant-v3,TD3,120000,120000
25,1156.9988659875025,250000,Ant-v3,TD3,125000,125000
26,1137.6962160275004,260000,Ant-v3,TD3,130000,130000
27,1302.2386948336698,270000,Ant-v3,TD3,135000,135000
28,1126.5082607676907,280000,Ant-v3,TD3,140000,140000
29,1271.173836784332,290000,Ant-v3,TD3,145000,145000
30,959.8496324308568,300000,Ant-v3,TD3,150000,150000
31,1094.7986515749146,310000,Ant-v3,TD3,155000,155000
32,1580.7437765545278,320000,Ant-v3,TD3,160000,160000
33,1427.664904454373,330000,Ant-v3,TD3,165000,165000
34,1500.8947143582136,340000,Ant-v3,TD3,170000,170000
35,1638.0596528490107,350000,Ant-v3,TD3,175000,175000
36,1678.5240549851765,360000,Ant-v3,TD3,180000,180000
37,1195.3183695096195,370000,Ant-v3,TD3,185000,185000
38,1719.5867579780927,380000,Ant-v3,TD3,190000,190000
39,1251.1450815428595,390000,Ant-v3,TD3,195000,195000
40,1171.3023864992294,400000,Ant-v3,TD3,200000,200000
41,1523.570453775137,410000,Ant-v3,TD3,205000,205000
42,1376.155576188404,420000,Ant-v3,TD3,210000,210000
43,1897.5472280161216,430000,Ant-v3,TD3,215000,215000
44,1432.1716979979983,440000,Ant-v3,TD3,220000,220000
45,1412.8692500384327,450000,Ant-v3,TD3,225000,225000
46,1805.8644933250007,460000,Ant-v3,TD3,230000,230000
47,1642.5470653372565,470000,Ant-v3,TD3,235000,235000
48,1801.4548906381706,480000,Ant-v3,TD3,240000,240000
49,2017.5726869881225,490000,Ant-v3,TD3,245000,245000
50,1536.0854528198886,500000,Ant-v3,TD3,250000,250000
51,2021.0526110068224,510000,Ant-v3,TD3,255000,255000
52,1782.1435057663393,520000,Ant-v3,TD3,260000,260000
53,2196.7602218496218,530000,Ant-v3,TD3,265000,265000
54,2088.363777718396,540000,Ant-v3,TD3,270000,270000
55,1972.9088931226502,550000,Ant-v3,TD3,275000,275000
56,1206.2867042826856,560000,Ant-v3,TD3,280000,280000
57,2286.7705413768012,570000,Ant-v3,TD3,285000,285000
58,2365.4648600719956,580000,Ant-v3,TD3,290000,290000
59,2266.255703941238,590000,Ant-v3,TD3,295000,295000
60,2239.638644309661,600000,Ant-v3,TD3,300000,300000
61,2284.603386130961,610000,Ant-v3,TD3,305000,305000
62,2370.3711535178045,620000,Ant-v3,TD3,310000,310000
63,2521.7305973960188,630000,Ant-v3,TD3,315000,315000
64,2457.376035314556,640000,Ant-v3,TD3,320000,320000
65,2669.7422293529157,650000,Ant-v3,TD3,325000,325000
66,1726.615689594045,660000,Ant-v3,TD3,330000,330000
67,2417.8704948671343,670000,Ant-v3,TD3,335000,335000
68,2624.495559407856,680000,Ant-v3,TD3,340000,340000
69,2653.364283527256,690000,Ant-v3,TD3,345000,345000
70,2731.969943171744,700000,Ant-v3,TD3,350000,350000
71,2347.484672873169,710000,Ant-v3,TD3,355000,355000
72,2536.234250543409,720000,Ant-v3,TD3,360000,360000
73,2513.207041412089,730000,Ant-v3,TD3,365000,365000
74,2553.304316024421,740000,Ant-v3,TD3,370000,370000
75,2698.232266556225,750000,Ant-v3,TD3,375000,375000
76,2483.382913274708,760000,Ant-v3,TD3,380000,380000
77,2646.2932818962468,770000,Ant-v3,TD3,385000,385000
78,2317.927808019264,780000,Ant-v3,TD3,390000,390000
79,2682.195048035124,790000,Ant-v3,TD3,395000,395000
80,1566.6556730922248,800000,Ant-v3,TD3,400000,400000
81,2090.2863557918745,810000,Ant-v3,TD3,405000,405000
82,2737.8771700937746,820000,Ant-v3,TD3,410000,410000
83,2775.314887284616,830000,Ant-v3,TD3,415000,415000
84,2543.3516844210035,840000,Ant-v3,TD3,420000,420000
85,3000.1634872561635,850000,Ant-v3,TD3,425000,425000
86,2690.635906635358,860000,Ant-v3,TD3,430000,430000
87,2468.976914989557,870000,Ant-v3,TD3,435000,435000
88,1933.266491880489,880000,Ant-v3,TD3,440000,440000
89,2860.2157936788044,890000,Ant-v3,TD3,445000,445000
90,2984.0989382155876,900000,Ant-v3,TD3,450000,450000
91,2714.305937142205,910000,Ant-v3,TD3,455000,455000
92,2778.860006456411,920000,Ant-v3,TD3,460000,460000
93,2655.4941652254884,930000,Ant-v3,TD3,465000,465000
94,2985.284710858775,940000,Ant-v3,TD3,470000,470000
95,2986.055000936824,950000,Ant-v3,TD3,475000,475000
96,3002.3246332446975,960000,Ant-v3,TD3,480000,480000
97,2988.417842957584,970000,Ant-v3,TD3,485000,485000
98,3062.429712982394,980000,Ant-v3,TD3,490000,490000
99,2855.488708785317,990000,Ant-v3,TD3,495000,495000
100,2977.2705582883477,1000000,Ant-v3,TD3,500000,500000
