index,Average Returns,Timesteps,env,algorithm_name,Actor Training Times,Actor Training Steps
0,-1.0524121038663952,0,HalfCheetah-v3,DDPG,0,0
1,-1.0524121038663952,10000,HalfCheetah-v3,DDPG,5000,5000
2,-272.013214724896,20000,HalfCheetah-v3,DDPG,10000,10000
3,-388.1836774436248,30000,HalfCheetah-v3,DDPG,15000,15000
4,-499.7236271544282,40000,HalfCheetah-v3,DDPG,20000,20000
5,-504.6436265439555,50000,HalfCheetah-v3,DDPG,25000,25000
6,402.45236434766286,60000,HalfCheetah-v3,DDPG,30000,30000
7,492.81613990279334,70000,HalfCheetah-v3,DDPG,35000,35000
8,1305.1926929282515,80000,HalfCheetah-v3,DDPG,40000,40000
9,381.33486231499984,90000,HalfCheetah-v3,DDPG,45000,45000
10,1281.1112167037234,100000,HalfCheetah-v3,DDPG,50000,50000
11,1796.3265202847647,110000,HalfCheetah-v3,DDPG,55000,55000
12,1659.089400337482,120000,HalfCheetah-v3,DDPG,60000,60000
13,2900.2991551798773,130000,HalfCheetah-v3,DDPG,65000,65000
14,110.63485736071381,140000,HalfCheetah-v3,DDPG,70000,70000
15,2897.051467458366,150000,HalfCheetah-v3,DDPG,75000,75000
16,2178.1691446136992,160000,HalfCheetah-v3,DDPG,80000,80000
17,3145.7281908223968,170000,HalfCheetah-v3,DDPG,85000,85000
18,3234.773404248122,180000,HalfCheetah-v3,DDPG,90000,90000
19,2287.173599650925,190000,HalfCheetah-v3,DDPG,95000,95000
20,3637.912078264329,200000,HalfCheetah-v3,DDPG,100000,100000
21,4301.253596481651,210000,HalfCheetah-v3,DDPG,105000,105000
22,2364.661466125791,220000,HalfCheetah-v3,DDPG,110000,110000
23,3876.3439710943294,230000,HalfCheetah-v3,DDPG,115000,115000
24,4084.4633907448206,240000,HalfCheetah-v3,DDPG,120000,120000
25,2812.6404100957184,250000,HalfCheetah-v3,DDPG,125000,125000
26,3802.650957450489,260000,HalfCheetah-v3,DDPG,130000,130000
27,3565.216868565841,270000,HalfCheetah-v3,DDPG,135000,135000
28,3459.5460370867495,280000,HalfCheetah-v3,DDPG,140000,140000
29,3779.253858072603,290000,HalfCheetah-v3,DDPG,145000,145000
30,3798.797409617763,300000,HalfCheetah-v3,DDPG,150000,150000
31,3710.8570729178728,310000,HalfCheetah-v3,DDPG,155000,155000
32,2032.4057492094971,320000,HalfCheetah-v3,DDPG,160000,160000
33,2475.402068413167,330000,HalfCheetah-v3,DDPG,165000,165000
34,1912.289873972673,340000,HalfCheetah-v3,DDPG,170000,170000
35,1450.3504335430746,350000,HalfCheetah-v3,DDPG,175000,175000
36,2179.5196425712893,360000,HalfCheetah-v3,DDPG,180000,180000
37,3117.0813667057873,370000,HalfCheetah-v3,DDPG,185000,185000
38,2334.813894038871,380000,HalfCheetah-v3,DDPG,190000,190000
39,3249.2324303557393,390000,HalfCheetah-v3,DDPG,195000,195000
40,3637.60147373702,400000,HalfCheetah-v3,DDPG,200000,200000
41,2641.817169856245,410000,HalfCheetah-v3,DDPG,205000,205000
42,1889.2354169579544,420000,HalfCheetah-v3,DDPG,210000,210000
43,3478.980383946165,430000,HalfCheetah-v3,DDPG,215000,215000
44,2570.321272911079,440000,HalfCheetah-v3,DDPG,220000,220000
45,2472.452533103453,450000,HalfCheetah-v3,DDPG,225000,225000
46,3696.078865012196,460000,HalfCheetah-v3,DDPG,230000,230000
47,3576.2938798298687,470000,HalfCheetah-v3,DDPG,235000,235000
48,2032.6498194675828,480000,HalfCheetah-v3,DDPG,240000,240000
49,2120.552097106248,490000,HalfCheetah-v3,DDPG,245000,245000
50,3674.0151180904163,500000,HalfCheetah-v3,DDPG,250000,250000
51,2881.2564168151666,510000,HalfCheetah-v3,DDPG,255000,255000
52,2714.431961203195,520000,HalfCheetah-v3,DDPG,260000,260000
53,2626.159592916902,530000,HalfCheetah-v3,DDPG,265000,265000
54,2362.5171648797045,540000,HalfCheetah-v3,DDPG,270000,270000
55,1521.7070497196287,550000,HalfCheetah-v3,DDPG,275000,275000
56,2499.0306681854017,560000,HalfCheetah-v3,DDPG,280000,280000
57,1995.110365169829,570000,HalfCheetah-v3,DDPG,285000,285000
58,2071.6415030615008,580000,HalfCheetah-v3,DDPG,290000,290000
59,785.7173158376528,590000,HalfCheetah-v3,DDPG,295000,295000
60,1755.5881430935906,600000,HalfCheetah-v3,DDPG,300000,300000
61,2447.757947413453,610000,HalfCheetah-v3,DDPG,305000,305000
62,1084.414037152222,620000,HalfCheetah-v3,DDPG,310000,310000
63,383.16208152173255,630000,HalfCheetah-v3,DDPG,315000,315000
64,87.23680639707905,640000,HalfCheetah-v3,DDPG,320000,320000
65,3070.8043428028186,650000,HalfCheetah-v3,DDPG,325000,325000
66,766.9691874604331,660000,HalfCheetah-v3,DDPG,330000,330000
67,2077.6420266137243,670000,HalfCheetah-v3,DDPG,335000,335000
68,952.776487224916,680000,HalfCheetah-v3,DDPG,340000,340000
69,881.9491855719891,690000,HalfCheetah-v3,DDPG,345000,345000
70,1139.3601910231073,700000,HalfCheetah-v3,DDPG,350000,350000
71,1389.5322989959711,710000,HalfCheetah-v3,DDPG,355000,355000
72,1308.089069987506,720000,HalfCheetah-v3,DDPG,360000,360000
73,477.9541197377883,730000,HalfCheetah-v3,DDPG,365000,365000
74,315.7651515992416,740000,HalfCheetah-v3,DDPG,370000,370000
75,669.6536837510188,750000,HalfCheetah-v3,DDPG,375000,375000
76,854.349938598852,760000,HalfCheetah-v3,DDPG,380000,380000
77,1438.137083169173,770000,HalfCheetah-v3,DDPG,385000,385000
78,717.7975334060872,780000,HalfCheetah-v3,DDPG,390000,390000
79,1293.8778922828924,790000,HalfCheetah-v3,DDPG,395000,395000
80,1375.765055668454,800000,HalfCheetah-v3,DDPG,400000,400000
81,165.96242142182786,810000,HalfCheetah-v3,DDPG,405000,405000
82,3757.66754961022,820000,HalfCheetah-v3,DDPG,410000,410000
83,1609.5807561162287,830000,HalfCheetah-v3,DDPG,415000,415000
84,1035.4048055473436,840000,HalfCheetah-v3,DDPG,420000,420000
85,1578.4830396894872,850000,HalfCheetah-v3,DDPG,425000,425000
86,2348.4711350098473,860000,HalfCheetah-v3,DDPG,430000,430000
87,2387.7421450203506,870000,HalfCheetah-v3,DDPG,435000,435000
88,1950.404268020144,880000,HalfCheetah-v3,DDPG,440000,440000
89,3254.027984320289,890000,HalfCheetah-v3,DDPG,445000,445000
90,2836.8014150258764,900000,HalfCheetah-v3,DDPG,450000,450000
91,1639.1138930053953,910000,HalfCheetah-v3,DDPG,455000,455000
92,2239.9598248282136,920000,HalfCheetah-v3,DDPG,460000,460000
93,1772.9050645277896,930000,HalfCheetah-v3,DDPG,465000,465000
94,3561.1606333695504,940000,HalfCheetah-v3,DDPG,470000,470000
95,3094.0622035571473,950000,HalfCheetah-v3,DDPG,475000,475000
96,2457.913525880885,960000,HalfCheetah-v3,DDPG,480000,480000
97,2132.260942516682,970000,HalfCheetah-v3,DDPG,485000,485000
98,2140.1509947833447,980000,HalfCheetah-v3,DDPG,490000,490000
99,2250.237737444263,990000,HalfCheetah-v3,DDPG,495000,495000
100,2502.257202675234,1000000,HalfCheetah-v3,DDPG,500000,500000
