index,Average Returns,Timesteps,env,algorithm_name,Actor Training Times,Actor Training Steps
0,-2.897064495834039,0,HalfCheetah-v3,SYS_QRDW,0,0
1,-2.897064495834039,10000,HalfCheetah-v3,SYS_QRDW,5000,5000
2,-594.556266610128,20000,HalfCheetah-v3,SYS_QRDW,10000,10000
3,878.0017449108744,30000,HalfCheetah-v3,SYS_QRDW,15000,15000
4,1915.5354752924552,40000,HalfCheetah-v3,SYS_QRDW,20000,20000
5,2491.7652380747795,50000,HalfCheetah-v3,SYS_QRDW,25000,25000
6,3504.194185600092,60000,HalfCheetah-v3,SYS_QRDW,30000,30000
7,3305.790301326549,70000,HalfCheetah-v3,SYS_QRDW,35000,35000
8,3378.8448834640235,80000,HalfCheetah-v3,SYS_QRDW,40000,40000
9,3995.461608861328,90000,HalfCheetah-v3,SYS_QRDW,45000,45000
10,4152.385269472056,100000,HalfCheetah-v3,SYS_QRDW,50000,50000
11,4740.55516404683,110000,HalfCheetah-v3,SYS_QRDW,55000,55000
12,4478.8143584398185,120000,HalfCheetah-v3,SYS_QRDW,60000,60000
13,5330.0058674530155,130000,HalfCheetah-v3,SYS_QRDW,65000,65000
14,5316.237374703029,140000,HalfCheetah-v3,SYS_QRDW,70000,70000
15,5970.130212838168,150000,HalfCheetah-v3,SYS_QRDW,75000,75000
16,6009.8966291330935,160000,HalfCheetah-v3,SYS_QRDW,80000,80000
17,6244.8769403566275,170000,HalfCheetah-v3,SYS_QRDW,85000,85000
18,6106.549395598869,180000,HalfCheetah-v3,SYS_QRDW,90000,90000
19,6610.121278748944,190000,HalfCheetah-v3,SYS_QRDW,95000,95000
20,6848.461870354304,200000,HalfCheetah-v3,SYS_QRDW,100000,100000
21,6546.40357912014,210000,HalfCheetah-v3,SYS_QRDW,105000,105000
22,7195.989716779448,220000,HalfCheetah-v3,SYS_QRDW,110000,110000
23,7472.227309241834,230000,HalfCheetah-v3,SYS_QRDW,115000,115000
24,7187.2105584851315,240000,HalfCheetah-v3,SYS_QRDW,120000,120000
25,7510.287167951661,250000,HalfCheetah-v3,SYS_QRDW,125000,125000
26,7847.8681708045,260000,HalfCheetah-v3,SYS_QRDW,130000,130000
27,7536.421289193091,270000,HalfCheetah-v3,SYS_QRDW,135000,135000
28,7805.803273088743,280000,HalfCheetah-v3,SYS_QRDW,140000,140000
29,7796.303767273268,290000,HalfCheetah-v3,SYS_QRDW,145000,145000
30,7897.629187190505,300000,HalfCheetah-v3,SYS_QRDW,150000,150000
31,8270.72442050751,310000,HalfCheetah-v3,SYS_QRDW,155000,155000
32,8251.513391812225,320000,HalfCheetah-v3,SYS_QRDW,160000,160000
33,8156.032617551146,330000,HalfCheetah-v3,SYS_QRDW,165000,165000
34,8556.23428087914,340000,HalfCheetah-v3,SYS_QRDW,170000,170000
35,8427.563122610416,350000,HalfCheetah-v3,SYS_QRDW,175000,175000
36,8624.275613490074,360000,HalfCheetah-v3,SYS_QRDW,180000,180000
37,8693.277911112482,370000,HalfCheetah-v3,SYS_QRDW,185000,185000
38,8569.251275344737,380000,HalfCheetah-v3,SYS_QRDW,190000,190000
39,8722.284466729083,390000,HalfCheetah-v3,SYS_QRDW,195000,195000
40,9088.752104479676,400000,HalfCheetah-v3,SYS_QRDW,200000,200000
41,9020.11412066597,410000,HalfCheetah-v3,SYS_QRDW,205000,205000
42,9044.93984052145,420000,HalfCheetah-v3,SYS_QRDW,210000,210000
43,8909.46432945208,430000,HalfCheetah-v3,SYS_QRDW,215000,215000
44,9538.8485715135,440000,HalfCheetah-v3,SYS_QRDW,220000,220000
45,9571.33254122991,450000,HalfCheetah-v3,SYS_QRDW,225000,225000
46,9635.605791212356,460000,HalfCheetah-v3,SYS_QRDW,230000,230000
47,8956.19886075153,470000,HalfCheetah-v3,SYS_QRDW,235000,235000
48,9173.036763093309,480000,HalfCheetah-v3,SYS_QRDW,240000,240000
49,9009.238805543684,490000,HalfCheetah-v3,SYS_QRDW,245000,245000
50,9803.769187500337,500000,HalfCheetah-v3,SYS_QRDW,250000,250000
51,9841.299906572312,510000,HalfCheetah-v3,SYS_QRDW,255000,255000
52,9845.465790805743,520000,HalfCheetah-v3,SYS_QRDW,260000,260000
53,9637.100369293346,530000,HalfCheetah-v3,SYS_QRDW,265000,265000
54,9671.89810682469,540000,HalfCheetah-v3,SYS_QRDW,270000,270000
55,9483.903826164236,550000,HalfCheetah-v3,SYS_QRDW,275000,275000
56,10024.83518289606,560000,HalfCheetah-v3,SYS_QRDW,280000,280000
57,10054.948751527196,570000,HalfCheetah-v3,SYS_QRDW,285000,285000
58,9917.317942485748,580000,HalfCheetah-v3,SYS_QRDW,290000,290000
59,10028.345540839757,590000,HalfCheetah-v3,SYS_QRDW,295000,295000
60,10232.843005804032,600000,HalfCheetah-v3,SYS_QRDW,300000,300000
61,10017.5164928446,610000,HalfCheetah-v3,SYS_QRDW,305000,305000
62,10008.067535771983,620000,HalfCheetah-v3,SYS_QRDW,310000,310000
63,10115.67819855772,630000,HalfCheetah-v3,SYS_QRDW,315000,315000
64,9811.185442627342,640000,HalfCheetah-v3,SYS_QRDW,320000,320000
65,9913.757356340022,650000,HalfCheetah-v3,SYS_QRDW,325000,325000
66,10137.03815948627,660000,HalfCheetah-v3,SYS_QRDW,330000,330000
67,10218.343576586198,670000,HalfCheetah-v3,SYS_QRDW,335000,335000
68,10335.055960197287,680000,HalfCheetah-v3,SYS_QRDW,340000,340000
69,10331.418168378641,690000,HalfCheetah-v3,SYS_QRDW,345000,345000
70,10271.170741601189,700000,HalfCheetah-v3,SYS_QRDW,350000,350000
71,10332.797271233743,710000,HalfCheetah-v3,SYS_QRDW,355000,355000
72,10264.073335599445,720000,HalfCheetah-v3,SYS_QRDW,360000,360000
73,10332.33241363762,730000,HalfCheetah-v3,SYS_QRDW,365000,365000
74,10439.662428936654,740000,HalfCheetah-v3,SYS_QRDW,370000,370000
75,10454.766468394091,750000,HalfCheetah-v3,SYS_QRDW,375000,375000
76,10281.207064073536,760000,HalfCheetah-v3,SYS_QRDW,380000,380000
77,10429.845146365598,770000,HalfCheetah-v3,SYS_QRDW,385000,385000
78,10155.998947421129,780000,HalfCheetah-v3,SYS_QRDW,390000,390000
79,10570.588283214864,790000,HalfCheetah-v3,SYS_QRDW,395000,395000
80,10396.670870937829,800000,HalfCheetah-v3,SYS_QRDW,400000,400000
81,10653.061782945022,810000,HalfCheetah-v3,SYS_QRDW,405000,405000
82,10707.306149870441,820000,HalfCheetah-v3,SYS_QRDW,410000,410000
83,10203.162354426651,830000,HalfCheetah-v3,SYS_QRDW,415000,415000
84,10349.307991301856,840000,HalfCheetah-v3,SYS_QRDW,420000,420000
85,10745.654219113161,850000,HalfCheetah-v3,SYS_QRDW,425000,425000
86,10566.57114521413,860000,HalfCheetah-v3,SYS_QRDW,430000,430000
87,10294.102896167438,870000,HalfCheetah-v3,SYS_QRDW,435000,435000
88,10726.901624798444,880000,HalfCheetah-v3,SYS_QRDW,440000,440000
89,10653.190206419626,890000,HalfCheetah-v3,SYS_QRDW,445000,445000
90,10539.492445853904,900000,HalfCheetah-v3,SYS_QRDW,450000,450000
91,10692.652825711659,910000,HalfCheetah-v3,SYS_QRDW,455000,455000
92,10329.307752854445,920000,HalfCheetah-v3,SYS_QRDW,460000,460000
93,10715.021479655496,930000,HalfCheetah-v3,SYS_QRDW,465000,465000
94,10505.352778847178,940000,HalfCheetah-v3,SYS_QRDW,470000,470000
95,10488.678981873543,950000,HalfCheetah-v3,SYS_QRDW,475000,475000
96,10497.580379624302,960000,HalfCheetah-v3,SYS_QRDW,480000,480000
97,10745.017902803262,970000,HalfCheetah-v3,SYS_QRDW,485000,485000
98,10461.036019429554,980000,HalfCheetah-v3,SYS_QRDW,490000,490000
99,10622.24395387278,990000,HalfCheetah-v3,SYS_QRDW,495000,495000
100,10821.047877104498,1000000,HalfCheetah-v3,SYS_QRDW,500000,500000
