index,Average Returns,Timesteps,env,algorithm_name,Actor Training Times,Actor Training Steps
0,-1.6983759337563742,0,HalfCheetah-v3,DDPG,0,0
1,-1.6983759337563742,10000,HalfCheetah-v3,DDPG,5000,5000
2,231.4478866775851,20000,HalfCheetah-v3,DDPG,10000,10000
3,934.1046451756844,30000,HalfCheetah-v3,DDPG,15000,15000
4,1106.0175534811012,40000,HalfCheetah-v3,DDPG,20000,20000
5,3070.804548041713,50000,HalfCheetah-v3,DDPG,25000,25000
6,2516.8179018171186,60000,HalfCheetah-v3,DDPG,30000,30000
7,4030.938713938399,70000,HalfCheetah-v3,DDPG,35000,35000
8,3782.413711721492,80000,HalfCheetah-v3,DDPG,40000,40000
9,3675.481922624903,90000,HalfCheetah-v3,DDPG,45000,45000
10,3808.914072651408,100000,HalfCheetah-v3,DDPG,50000,50000
11,4002.935477777452,110000,HalfCheetah-v3,DDPG,55000,55000
12,3915.0985593029322,120000,HalfCheetah-v3,DDPG,60000,60000
13,4227.713755203029,130000,HalfCheetah-v3,DDPG,65000,65000
14,4282.227657224616,140000,HalfCheetah-v3,DDPG,70000,70000
15,4311.28345573164,150000,HalfCheetah-v3,DDPG,75000,75000
16,4448.729005905838,160000,HalfCheetah-v3,DDPG,80000,80000
17,4478.893335038936,170000,HalfCheetah-v3,DDPG,85000,85000
18,4422.166885427705,180000,HalfCheetah-v3,DDPG,90000,90000
19,4623.474102596035,190000,HalfCheetah-v3,DDPG,95000,95000
20,4820.148025872555,200000,HalfCheetah-v3,DDPG,100000,100000
21,4975.263323295696,210000,HalfCheetah-v3,DDPG,105000,105000
22,4939.366759762812,220000,HalfCheetah-v3,DDPG,110000,110000
23,5328.9255980138205,230000,HalfCheetah-v3,DDPG,115000,115000
24,5384.314628854655,240000,HalfCheetah-v3,DDPG,120000,120000
25,5673.622586760577,250000,HalfCheetah-v3,DDPG,125000,125000
26,5743.515458375636,260000,HalfCheetah-v3,DDPG,130000,130000
27,5795.416992734467,270000,HalfCheetah-v3,DDPG,135000,135000
28,5802.22149190625,280000,HalfCheetah-v3,DDPG,140000,140000
29,5689.403869942983,290000,HalfCheetah-v3,DDPG,145000,145000
30,5660.405983190376,300000,HalfCheetah-v3,DDPG,150000,150000
31,5843.1918795869,310000,HalfCheetah-v3,DDPG,155000,155000
32,6034.689652449372,320000,HalfCheetah-v3,DDPG,160000,160000
33,6026.924689836132,330000,HalfCheetah-v3,DDPG,165000,165000
34,6015.522475867255,340000,HalfCheetah-v3,DDPG,170000,170000
35,5913.225881715601,350000,HalfCheetah-v3,DDPG,175000,175000
36,5826.275578628993,360000,HalfCheetah-v3,DDPG,180000,180000
37,6071.055068068702,370000,HalfCheetah-v3,DDPG,185000,185000
38,6255.8100201100915,380000,HalfCheetah-v3,DDPG,190000,190000
39,6083.6089775687415,390000,HalfCheetah-v3,DDPG,195000,195000
40,6359.380597468851,400000,HalfCheetah-v3,DDPG,200000,200000
41,6213.788558652813,410000,HalfCheetah-v3,DDPG,205000,205000
42,6224.090407990339,420000,HalfCheetah-v3,DDPG,210000,210000
43,6198.414167831796,430000,HalfCheetah-v3,DDPG,215000,215000
44,6382.46128981855,440000,HalfCheetah-v3,DDPG,220000,220000
45,6264.282401990199,450000,HalfCheetah-v3,DDPG,225000,225000
46,6303.0985676765085,460000,HalfCheetah-v3,DDPG,230000,230000
47,6442.224907697262,470000,HalfCheetah-v3,DDPG,235000,235000
48,6466.657296290194,480000,HalfCheetah-v3,DDPG,240000,240000
49,6705.830367278798,490000,HalfCheetah-v3,DDPG,245000,245000
50,6316.169196173913,500000,HalfCheetah-v3,DDPG,250000,250000
51,6450.079802986609,510000,HalfCheetah-v3,DDPG,255000,255000
52,6727.405715149921,520000,HalfCheetah-v3,DDPG,260000,260000
53,6644.310973611316,530000,HalfCheetah-v3,DDPG,265000,265000
54,6141.885523715468,540000,HalfCheetah-v3,DDPG,270000,270000
55,6252.990222649863,550000,HalfCheetah-v3,DDPG,275000,275000
56,6521.407186481508,560000,HalfCheetah-v3,DDPG,280000,280000
57,6353.994283646601,570000,HalfCheetah-v3,DDPG,285000,285000
58,6693.595054453695,580000,HalfCheetah-v3,DDPG,290000,290000
59,6795.023962891149,590000,HalfCheetah-v3,DDPG,295000,295000
60,6551.288419102257,600000,HalfCheetah-v3,DDPG,300000,300000
61,6645.915997204648,610000,HalfCheetah-v3,DDPG,305000,305000
62,6748.894123681452,620000,HalfCheetah-v3,DDPG,310000,310000
63,6656.0318231518995,630000,HalfCheetah-v3,DDPG,315000,315000
64,7070.3507616788975,640000,HalfCheetah-v3,DDPG,320000,320000
65,5951.910508502366,650000,HalfCheetah-v3,DDPG,325000,325000
66,6665.423423313958,660000,HalfCheetah-v3,DDPG,330000,330000
67,7191.905181833141,670000,HalfCheetah-v3,DDPG,335000,335000
68,7383.731399172278,680000,HalfCheetah-v3,DDPG,340000,340000
69,7504.323820129403,690000,HalfCheetah-v3,DDPG,345000,345000
70,7399.049852298521,700000,HalfCheetah-v3,DDPG,350000,350000
71,7413.185311265106,710000,HalfCheetah-v3,DDPG,355000,355000
72,6963.549352666768,720000,HalfCheetah-v3,DDPG,360000,360000
73,7269.89251618322,730000,HalfCheetah-v3,DDPG,365000,365000
74,7309.443707036671,740000,HalfCheetah-v3,DDPG,370000,370000
75,7230.503897556223,750000,HalfCheetah-v3,DDPG,375000,375000
76,7554.334272213591,760000,HalfCheetah-v3,DDPG,380000,380000
77,7737.998816386468,770000,HalfCheetah-v3,DDPG,385000,385000
78,7530.4511167976725,780000,HalfCheetah-v3,DDPG,390000,390000
79,7896.883957228226,790000,HalfCheetah-v3,DDPG,395000,395000
80,7645.982948132577,800000,HalfCheetah-v3,DDPG,400000,400000
81,7710.000261841332,810000,HalfCheetah-v3,DDPG,405000,405000
82,7683.357038262174,820000,HalfCheetah-v3,DDPG,410000,410000
83,7669.301902930774,830000,HalfCheetah-v3,DDPG,415000,415000
84,7608.86897295057,840000,HalfCheetah-v3,DDPG,420000,420000
85,7797.814894098821,850000,HalfCheetah-v3,DDPG,425000,425000
86,7358.816455236655,860000,HalfCheetah-v3,DDPG,430000,430000
87,7360.660759091236,870000,HalfCheetah-v3,DDPG,435000,435000
88,7841.647929543351,880000,HalfCheetah-v3,DDPG,440000,440000
89,7507.617883319743,890000,HalfCheetah-v3,DDPG,445000,445000
90,7992.168189296774,900000,HalfCheetah-v3,DDPG,450000,450000
91,8043.677620124184,910000,HalfCheetah-v3,DDPG,455000,455000
92,7976.528929663041,920000,HalfCheetah-v3,DDPG,460000,460000
93,7898.335416921756,930000,HalfCheetah-v3,DDPG,465000,465000
94,8061.550582220794,940000,HalfCheetah-v3,DDPG,470000,470000
95,7907.137516284671,950000,HalfCheetah-v3,DDPG,475000,475000
96,7787.6139807919035,960000,HalfCheetah-v3,DDPG,480000,480000
97,7738.771845942241,970000,HalfCheetah-v3,DDPG,485000,485000
98,7939.607577990592,980000,HalfCheetah-v3,DDPG,490000,490000
99,8158.094474202009,990000,HalfCheetah-v3,DDPG,495000,495000
100,7936.977291767775,1000000,HalfCheetah-v3,DDPG,500000,500000
